########################################################################
########################################################################
########################################################################
########################################################################
#######.......#######.......############################################
#######.......+.+.+.+.......############################################
#######.......###+###.......############################################
#################.###############.....##################################
#######.......###+###.......#####.....+.......##########################
#######.......+.+.+.+.......#####....<#######.##########################
#######.......###+###.......#####.....#######.##########################
#################.#################+#########.####......################
#######.......###+###.......#######.#########.####......################
#######.......+.+.+.+.......#######.#########....+......################
#######.......###+###.......#######.##############......################
#################.#################.##############......+.........######
#################+#################.##############......#########+######
#####>........+.....................################.############.######
#####.#...#...########+#############################+############+######
#####...#...#.########+#########################...+.+............######
#####.#...#...#####........#####################.################+######
#####...#...#.#####........#####################+###########........####
#####.#...#...#####........###############..........########........####
#####...#...#.#####........+.............+..........########........####
#####.........#####........#######+#######..........########........####
#########+#########........#######.###########+#############........####
#########.#########+#####+#######...########.+.............+........####
#########...........#####.######.....#######+###############........####
#########################.######.....#######.###############........####
#########################.###............###.###########################
#########################....................###########################
#########################.###............###.###########################
#########################.######.....#######.###########################
#########################.######.....#######.###########################
#########################.#######...########.###########################
#########################.########.#########.###########################
#########################....................###########################
########################################################################
########################################################################
########################################################################
########################################################################
########################################################################
