########################################################################
##############################~~########################################
###############################~~#######################################
################################~~~###########.....#####################
##################################~~~~~#####.........###################
######################################~~~~~~..........##################
############<############################::~~.............##############
############.############################+#:.~~~......###.##############
############.############################.###..~~~=...###.##############
############.####################....>###.####.#.~==~####...############
############.####################.....###.######...=~~#####..###########
############.....+.+......+.+...+.....###.######.....~~#####.###########
######....########+###+####+#####.....###.#######.....~~~###..##########
######.^..########.##...###.#####..^..###+##########....~####.##########
######....########.##...###.#####.....+...############..~~~##..#########
######....+........##...###.#####.....###.#############..#~~##.#########
######....###########...###.#####.....###.#############..##~##..########
######....############+####+#####.....###.##############.##~###.########
################..........+.+..##########.##############.##~###..#######
################.#############.##########+##############...~####..######
################.#############.#............##############.~~~###...####
################.#############.+...####.....##############..~~~####..###
################.###############...#..+.....#############.....~~####.###
################.###############...####.....############..###..~~###.###
################.###############............############.####..#~##..###
################.##########################.###########..#.#..##~~#.####
####.......#####.##########################..#########......#####~==####
####.......#####.###########################..###..###..##.######..~~~##
####....^..#####.........####################..#....##.......###..###~~#
####.......#############.#####################................#..#####~#
#######+################+######################.................######~#
#######..###############......################.................#########
########...............+......################................##########
########################......################...............###########
##############################################.....#####################
###############################################...######################
########################################################################
########################################################################
########################################################################
########################################################################
########################################################################
########################################################################
