########################################################################
#......................................................................#
#........##########....................................................#
#........##########....................................................#
#........##########...................................############.....#
#........##########.........#############.............############.....#
#........##########.........#############.............############.....#
#........##########.........#############.............############.....#
#........#######3##.........#############.............############.....#
#...........................#############.............####5#######.....#
#...........................#############..............................#
#...........................#####4#######..............................#
#......................................................................#
#......................................................................#
#......................................................................#
#.........######...................................#########...........#
#.........######...................................#########...........#
#.........#####2...............#+#.................#########...........#
#.........######..............##.##................6########...........#
#.........######..............+.>.+................#########...........#
#.........######..............##.##................#########...........#
#..............................#+#.................#########...........#
#..................................................#########...........#
#......................................................................#
#......................................................................#
#......................................................................#
#.......###############......................#####7#######.............#
#.......###############......................#############.............#
#.......###############.......######.........#############.............#
#.......##########1####.......######.........#############.............#
#.............................######.........#############.............#
#.............................######.........#############.............#
#.............................######.........#############.............#
#.......###############.......#####8.........#############.............#
#.......#.............#.......######.........#############.............#
#.......#.............+.......######...................................#
#.......#.............#.......######.........................#####.....#
#.......#.............#.......######.........................#####.....#
#.......###############......................................####9.....#
#............................................................#####.....#
#......................................................................#
########################################################################
